,A,B,C,D,E,F,G,H,I,J,K
A,0,1,0,0,0,0,0,0,0,0,0
B,1,0,5,0,0,4,0,0,0,0,0
C,0,5,0,2,0,0,0,0,0,0,0
D,0,0,2,0,3,0,0,0,0,0,0
E,0,0,0,3,0,0,0,1,0,0,0
F,0,4,0,0,0,0,3,0,5,0,0
G,0,0,0,0,0,3,0,3,0,4,0
H,0,0,0,0,1,0,3,0,0,0,4
I,0,0,0,0,0,5,0,0,0,4,0
J,0,0,0,0,0,0,4,0,4,0,4
K,0,0,0,0,0,0,0,4,0,4,0